.
.
.
.
.....#########################################.....
.....#.......................................#
.....#.......................................#
.....#.......................................#
.....#.....#.......#......#..................#
.....#.....#.......#......#..................#
.....#.....#.......#......#..................#
.....#.......................................#
.....#.......................................#
.....#.....#.......#......#..................#
.....#.....#.......#......#..................#
.....#.......................................#
.....#.......................................#
.....#########################################
.
.
.
.