,,,,,,,,,,,,,,,,,,,,,,,,,,,,,,,,,,,,,,,,,,,,,,,,,,,,,,,,,,,,,,,,,,,,,,
,,,,,,,,,,,,,,,,,,,,,,,,,,,,,,,,,,,,,,,,,,,,,,,,,,,,,,,,,,,,,,,,,,,,,,
,,,,,,,,,,,,,,,,,,,,,,,,,,,,,,,,,,,,,,,,,,,,,,,,,,,,,,,,,,,,,,,,,,,,,,
,,,,,,,,,,,,,,,,,,,,,,,,,,,,,,,,,,,,,,,,,,,,,,,,,,,,,,,,,,,,,,,,,,,,,,
,,,,,,,,,,,,,,,,,,,,,,,,,,,,,,,,,,,,,,,,,,,,,,,,,,,,,,,,,,,,,,,,,,,,,,
,,,,,,,,,,,,,,,,,,,,,,,,,,,,,,,,,,,,,,,,,,,,,,,,,,,,,,,,,,,,,,,,,,,,,,
,,,,,,,,,,,,,,,,,,,,,,,,,,,,,,,,,,,,,,,,,,,,,,,,,,,,,,,,,,,,,,,,,,,,,,
,,,,,,,,######################################################,,,,,,,,
,,,,,,,,#....................................................#,,,,,,,,
,,,,,,,,#....................................................#,,,,,,,,
,,,,,,,,#....................................................#,,,,,,,,
,,,,,,,,#....................................................#,,,,,,,,
,,,,,,,,#....................................................#,,,,,,,,
,,,,,,,,#....................................................#,,,,,,,,
,,,,,,,,#..................#.......#......#..................#,,,,,,,,
,,,,,,,,#..................#.......#......#..................#,,,,,,,,
,,,,,,,,#....................................................#,,,,,,,,
,,,,,,,,#....................................................#,,,,,,,,
,,,,,,,,#..................#.......#......#..................#,,,,,,,,
,,,,,,,,#..................#.......#......#..................#,,,,,,,,
,,,,,,,,#....................................................#,,,,,,,,
,,,,,,,,#....................................................#,,,,,,,,
,,,,,,,,#..................#.......#......#..................#,,,,,,,,
,,,,,,,,#....................................................#,,,,,,,,
,,,,,,,,#....................................................#,,,,,,,,
,,,,,,,,#..................#.......#......#..................#,,,,,,,,
,,,,,,,,#..................#.......#......#..................#,,,,,,,,
,,,,,,,,#....................................................#,,,,,,,,
,,,,,,,,#....................................................#,,,,,,,,
,,,,,,,,#....................................................#,,,,,,,,
,,,,,,,,#....................................................#,,,,,,,,
,,,,,,,,#....................................................#,,,,,,,,
,,,,,,,,#....................................................#,,,,,,,,
,,,,,,,,######################################################,,,,,,,,
,,,,,,,,,,,,,,,,,,,,,,,,,,,,,,,,,,,,,,,,,,,,,,,,,,,,,,,,,,,,,,,,,,,,,,
,,,,,,,,,,,,,,,,,,,,,,,,,,,,,,,,,,,,,,,,,,,,,,,,,,,,,,,,,,,,,,,,,,,,,,
,,,,,,,,,,,,,,,,,,,,,,,,,,,,,,,,,,,,,,,,,,,,,,,,,,,,,,,,,,,,,,,,,,,,,,
,,,,,,,,,,,,,,,,,,,,,,,,,,,,,,,,,,,,,,,,,,,,,,,,,,,,,,,,,,,,,,,,,,,,,,
,,,,,,,,,,,,,,,,,,,,,,,,,,,,,,,,,,,,,,,,,,,,,,,,,,,,,,,,,,,,,,,,,,,,,,
,,,,,,,,,,,,,,,,,,,,,,,,,,,,,,,,,,,,,,,,,,,,,,,,,,,,,,,,,,,,,,,,,,,,,,
,,,,,,,,,,,,,,,,,,,,,,,,,,,,,,,,,,,,,,,,,,,,,,,,,,,,,,,,,,,,,,,,,,,,,,
.