.
.
.
.
.
.
.
.......######################################################.......
.......#....................................................#
.......#....................................................#
.......#..................#.......#......#..................#
.......#..................#.......#......#..................#
.......#....................................................#
.......#..................#.......#......#..................#
.......#..................#.......#......#..................#
.......#....................................................#
.......#..................#.......#......#..................#
.......#..................#.......#......#..................#
.......#....................................................#
.......#..................#.......#......#..................#
.......#..................#.......#......#..................#
.......#....................................................#
.......#....................................................#
.......######################################################
.
.
.
.
.
.
.
.